AAAAAAAAAAAAA
BBBBBBBBBBBBB
CCCCCCCCCCCCC
CCCCCCCCCCCCC
BBBBBBBBBBBBB
AAAAAAAABCDEF
ABCDEFAAAAAAA
CCCCCCCCCCCCC
